SO ./textures/side0.xpm





NO ./textures/side1.xpm
WE ./textures/side3.xpm
EA ./textures/side4.xpm

F	255,255,255
C	255,100,0

    1   1111111111111111111111111
   101  1000000000110000000000001
   101  1011000001110000000000001
   101  1001000000000000000000001
111101111010000000110000000000001
100000000000000001110111111111111
11110111111110011100000010001
11110111111110011101010010001
11000000110001011100000000001
10000000000000000000000010001
10000N00000000001101010010001
1100000111010011111101111000111
11110111 111001 101111010001
11110111 111111 111111111111
			101
			101
			101
			101
			101
			101
			 1