SO ./path_to_the_south_texture
NO ./path_to_the_north_texture
WE ./path_to_the_west_texture
EA ./path_to_the_east_texture
F	255,255,255
C	0,0,0
        1111111111111111111111111
        1000000000110000000000001
        1011000001110000000000001
        1001000000000000000000001
111111111010000000110000000000001
100000000000000001110111111111111
11110111111110011100000010001
11110111111110011101010010001
11000000110001011100000000001
10000000000000001100000010001
10000N00000000001101010010001
1100000111010011111101111000111
11110111 111001 101111010001
11111111 111111 111111111111