SO ./textures/side0.xpm





EA ./textures/side4.xpm
NO ./textures/side1.xpm
WE ./textures/side3.xpm
F	0,255,0,
C	255,0,10,


   111    1111111111111111111111111
   101    1000000000110000000000001
   101    1011000001110000000000001
   101    1001000000000000000000001
1111011111100000001100000000000011
100000000000000001110111111111111
11110111111110011100000010001
11110111111110011101010010001
11000000110001011100000000001
10000000000000001100000010001
10000N00000000001101010010001
1100000111010011111101111000111
11110011 111001 101111010001
11111011 111111 111111111111
    101
	   101
	   101
	   101
	   101
	   111