SO ./path_to_the_south_texture
NO ./path_to_the_north_texture
WE ./path_to_the_west_texture
EA ./path_to_the_east_texture
F	224,255,4
C	225,34,4
        1111111111111111111111111
        1000000000110000000000001
        1011000001110000000000001
        1001000000000000000000001
111111111010000000110000000000001
100000000011000001110111111111111
11110111111111111100000010001
11110111111111011101010010001
11000000110101011100000010001
10000000101000001100000010001
1000N000000000001101010010001
1100000111010101111101111000111
11110111 1110101 101111010001
11111111 111111 111111111111