SO ./path_to_the_south_texture
NO ./path_to_the_north_texture
WE ./path_to_the_west_texture
EA ./path_to_the_east_texture
F	255,255,255
C	0,0,0
          111111111111111111111
         10000000011000000000001
        1000000000110000000000001
        1000000000D00000000000001
111111111000000000110000000000001
10000000D000000001110111111111111
1000000011111D111100000000001
1111D111100000000100000000001
11000000100000000100000000001
10000000D00000000D00000000001
10000N001000000001111D1100001
1111D1111111D1111111000111111
10000001 100001 100000000001
11111111 111111 111111111111